quality	Quality
substandard	Quality
durable	Quality
materials	Quality
leather	Quality
handle	Handles
sling	Handles
hook	Handles
sleeve	Handles
shoulder	Handles
storage	Compartments
slot	Compartments
pokets	Compartments
pocket	Compartments
compartments	Compartments
inch	Size_Fit
large	Size_Fit
room	Size_Fit
size	Size_Fit
fit	Size_Fit
shiny	Looks
red	Looks
color	Looks
picture	Looks
fancy	Looks
price	Price
worth	Price
money	Price
pay	Price
$	Price
denting	Protection
secure	Protection
scratches	Protection
protected	Protection
cushioning	Protection
emailing	Customer_service
refund	Customer_service
warranty	Customer_service
communication	Customer_service
shipping	Customer_service
