comfortable	Comfort
place	Comfort
ear	Comfort
fit	Comfort
cheap	Price
price	Price
$	Price
money	Price
expensive	Price
hearing	Sound
hear	Sound
sounds	Sound
noise	Sound
design	Look
model	Look
color	Look
setting	Connectivity
pair	Connectivity
attach	Connectivity
connect	Connectivity
battery	Battery
life	Battery
charge	Battery
%	Battery
wore	Durability
moisture	Durability
week	Durability
year	Durability
adjust	Ease_of_use
button	Ease_of_use
accessible	Ease_of_use
easy	Ease_of_use
control	Ease_of_use
convenient	Ease_of_use
