footwear	Materials
leather	Materials
soft	Materials
glue	Materials
cushioning	Materials
material	Materials
fallen	Durability
last	Durability
torn	Durability
comfortable	Comfort
comfort	Comfort
fit	Comfort
hurt	Comfort
slip	Comfort
rubbing	Comfort
style	Look
shine	Look
attractive	Look
look	Look
money	Price
$	Price
pay	Price
expensive	Price
seller	Price
weather	Weather_resistance
leaked	Weather_resistance
dry	Weather_resistance
rainboots	Weather_resistance
red	Color
purple	Color
colour	Color
larger	Size
size	Size
inches	Size
8	Size
