inexpensive	Price
affordable	Price
bucks	Price
dollar	Price
quirks	Layout
small	Layout
key	Layout
layout	Layout
positioning	Layout
effort	Feel_Comfort
hurt	Feel_Comfort
pain	Feel_Comfort
responsive	Feel_Comfort
wrist	Feel_Comfort
slipping	Feel_Comfort
clickyness	Feel_Comfort
construction	Build_Quality
plastic	Build_Quality
quality	Build_Quality
popped	Build_Quality
durability	Build_Quality
working	Build_Quality
squeak	Noise
quiet	Noise
connection	Connectivity
USE	Connectivity
syncs	Connectivity
bluetooth	Connectivity
plug	Connectivity
illumination	Extra_functionality
bright	Extra_functionality
button	Extra_functionality
backlight	Extra_functionality
batteries	Extra_functionality
